Get Key to Open the Door
#######
#....D#
#.....#
#..k..#
#P....#
#######
