#########
#P.Fw.kD#
#...#...#
#...#...#
#########
