Mole Can Dig Through Dirt
########
#P.M..D#
#......#
###d##d#
#.....k#
########
