Gorilla Can Push Boulders
########
#P.G..D#
#......#
#.b....#
##.#####
#..Fw..#
#...#ww#
#...#wk#
########