Get Key to Open the Door
#########
#P..k..D#
#...#...#
#.......#
#########
