Boss Level
#########
#P.Md.kD#
#.......#
#.......#
#########
