#########
#P.Gb.kD#
#.......#
#.......#
#########
