Boss Level
########
#P.M..D#
#......#
###d##d#
#...#.F#
#...#..#
#G..#dw#
#...b..#
#...b.k#
########
