Get Key to Open the Door
#########
#P..k..D#
#...#...#
#F...w.w#
#..dd.M.#
###dd####
###..Gb.#
#########
