Boss Level
########
#P.M...##
#.....bwD#
#......##
###d##d#
#...#.F#
#...w..#
#G..#dw#
#...b..#
#...b.k#
########
